1111111111111111111
10P01000000010C00E1
10001001110C1001111
10C01000C1001000001
1000001001000001C01
1111111111111111111