1111111111111
1001CCCC00001
1000011111C01
1P0011C0E00C1
1111111111111