11111111111111111111111111111111111
1P0000000000000000000000000000C0001
10111111111111011101111111111101101
10111111111111011101111111111101101
101000000X00C000C001000000000000001
10101111111111101101011111111110101
1010111111111110110101111111111C101
101000000000C0000C010C00C000C000001
10101111111111101101011111111110101
10101111111111101101011111111110101
10100000000000000001000000000000001
10111111111111011101111111111101101
1011111111E111101110111111111101101
101C00C0000000C00001000000XX0C00001
10101111111111101101011111111110101
10101111111111101101011111111110101
101000C0000000X00000100000000000001
10111111111111011101111111111101101
1000C00000000000C01000000000000C001
11111111111111111111111111111111111
