1111111111111
1001C00C00001
1000011111C01
1P0011E0000C1
1111111111111