1111111111
11000C0111
10C0000C01
1110C00X01
1XC0001P11
100C0000C1
1111110011
10E01C10X1
1000000001
1111111111